2 13 31
###############################
# p    #* *  1   2 *  * * *   #
# # # # # # # # # # # #*#*#*# #
#  x*     ***  *  1   * 2 * * #
# # # # # #*# # #*# # # # # #*#
#f         x  *  *      1     #
# # # # # # # #   #*# #*# # # #
#*  *         *      *    x   #
# # # # #*# # # #*#*# # # # # #
#*    **  *       *  1        #
# #*# # # # # # # # # # # # # #
#     2     *   *  *          #
###############################


cái này để test thôi, sửa lại cho đẹp nhá